0  0  0 0  0  0  0  0 
0 23  25 22 28  28 27 0
0 24 29 20 30 29 26 0
0 18 26 17 27 18 17 0
0 13 21 13 20 13 12 0
0 13 18 13 17 13 9 0
0 10 17 12 16 10 8 0
0 0 18 15 18 8 5 0
0 0 16 17 14 3 4 0
0 0 13 15 9 1 3 0
0 0 10 13 5 0 2 0
0 0 0 0 0 0 1 0
0 0 0 0 0 0 0 0
